50 50
***************************------*****************
**************************************************
**************************************************
****************************************-*********
****************************************-*********
******-***********#*********************-*********
-------*********************************-*********
******-*********************************-*********
******-************************----------*********
******-*************------**************-*********
****************************************-*********
****************************************-******-**
****************************************-******-**
****************************************-******-**
****************************************-******-**
****************************************-******-**
****************************************-******-**
**************-----------***************-******-**
********-*******************************-******-**
********-************************************-----
********-*****************-********************-**
********-*****************-********************-**
********-*****************-********************-**
****-------------*********-********************-**
----**********************-********************-**
---***********************-***********************
**************************-**-********************
*********--------------***-**-********************
**************************-**-****************----
**************************-**-********************
**************************-**-********************
*****************************-***-********-*******
*****************************-***-********-*******
***************************-*-***-*******$-*******
*-*************-**------***-*-***-********-*******
*-*************-***********-*-***-********-*******
*-*************-***********-*-***-********-*******
*-*************-***********-*-***-********-*******
*-*************-***********-*****-********-*******
*-*************-*****************-****************
*-*************-***************-*-****************
*-*************-***************-*-****************
*-*****-*******-***************-*-****************
*-*****-*******-***************-*-****************
*-*****-*******-***************-*-****************
-******-*******-***************-******************
******-----****-***************-**********-------*
*******-*******-**********************************
*******-******************************************
*******-******************************************
