13 15
***#***********
***************
-------------**
***************
***************
***************
***************
**-************
**-************
**-****--------
**-************
**-****-****$**
**-****-*******